
============================
BDD : Loca-Auto
============================

=======    table : billing=======
b_id	Auto_increment
b_durationRent	Int

=======    table : carDetails      =======
cd_id	Auto_increment
cd_brandSerie	Varchar
cd_type		Varchar
cd_seats		Int
cd_gearbox	Varchar
cd_energy	Varchar
cd_mileage	Varchar

=======    table : carToRent     =======
ctr_id	Auto_increment
ctr_gamme	Varchar
ctr_immatriculation	Varchar
ctr_pricePerDay	Float
ctr_km	Int
ctr_year	Int
ctr_img	Varchar
ctr_toArchive	Bool

=======    table : location =======
l_id	Auto_increment
l_startDate	Date
l_endDate	Date
l_realReturnDate	Date
l_plannedKm	Int
l_realKm		Int
l_chosenOptions	Varchar

=======    table : options     =======
o_id	Auto_increment
o_prestation	Varchar
o_pricePrestation	Float

=======    table : packageKm   =======
pk_id	Auto_increment
pk_kmPackage	Varchar
pk_kmPackageCost	Float

=======    table : packagePeriod   =======
pp_id	Auto_increment
pp_dayPeriod	Varchar
pp_ratePerPeriod	Float

=======    table : user      =======
u_id	Auto_increment
u_lastname	Varchar
u-firstname	Varchar
u_mail	Varchar
u_pwd	Varchar
u_phone	Varchar
u_birthdate	Date
u_toArchive	Bool

=======    table : user Opinion     =====
uo_id	Auto_increment
uo_stars	Int
uo_comm	Text






















